 -----------       -----------
 |....|....---     |.........|
 |..``|``...@|     |.........|
 |.....`...---     |.........|
 |....|....|       |....<....|
 |-.---------      |.........|
 |..`.|.....|      |.........|
 |.``.|`.`.`|      |.........|
 |..`.....`.|      |.........|
 |.```|`..`.----------------+|
 |....|..`.`.^^^^^^^^^^^^^^^.|
 -----------------------------
