 --------------------------
 |@......^^^^^^^^^^^^^^^^.|
 |.......----------------.|
 -------.------         |.|
  |...........|         |.|
  |.`.`.`.`.`.|         |.|
 --------.----|         |.|
 |...`.`..`.`.|         |.|
 |...`........|         |.|
 -----.--------   ------|.|
  |..`.`.`...|  --|.....|.|
  |.....`....|  |.+.....|.|
  |.`.`...`.--  |-|.....|.|
 -------.----   |.+.....+.|
 |..`.....|     |-|.....|--
 |........|     |.+.....|
 |...------     --|.....|
 -----            -------
