   ------------------------
   |..^^^^^^^^^^^^^^^^^^..|
   |..-------------------.|
 ----.|    -----        |.|
 |..|`--  --...|        |.|
 |.....|--|.`..|        |.|
 |.``..|..|..`.|        |.|
 --..``|...``.--        |.|
  |`..`...|`..|   ------|.|
  |.``.|..|..`| --|.....|.|
  |.`.`---|.`.| |.+.....|.|
  |.......|..-- |-|.....|.|
  ----.`..|.--  |.+.....+.|
     ---.--.|   |-|.....|--
      |.`...|   |.+.....|
      |@.|..|   --|.....|
      -------     -------
