-------- ------
|<|@...---....|
|^|-.``....`..|
|^||..``|.`.`.|
|^||....|.....|
|^|------`----|
|^|    |......|
|^------......|
|..^^^^````...|
|..-----......|
----   --------
